10
+--+--+--+--+--+--+--+--+--+--+
      |     |  |  |     |  |  |
+--+  +  +--+  +  +--+  +  +  +
|  |        |  |        |     |
+  +--+  +--+  +  +--+  +--+  +
|     |        |  |           |
+  +  +--+  +  +  +  +  +--+  +
|  |     |  |     |  |  |  |  |
+--+--+  +  +  +--+--+--+  +--+
|           |                 |
+  +  +--+--+  +--+  +--+  +  +
|  |        |     |     |  |  |
+--+  +--+--+  +  +--+--+--+  +
|        |  |  |        |  |  |
+  +--+  +  +--+--+--+  +  +  +
|     |     |        |     |  |
+  +  +--+--+--+--+  +--+--+  +
|  |  |  |     |              |
+  +--+  +--+  +--+  +  +  +--+
|           |        |  |      
+--+--+--+--+--+--+--+--+--+--+
