5
+--+--+--+--+--+
         |     |
+  +--+--+  +--+
|        |  |  |
+  +--+--+  +  +
|  |     |     |
+  +  +--+  +--+
|              |
+  +--+--+  +  +
|     |     |
+--+--+--+--+--+
