25
+--+--+--+--+--+--+--+--+--+--+--+--+--+--+--+--+--+--+--+--+--+--+--+--+--+
         |                 |  |  |     |  |              |  |  |        |  |
+  +--+--+  +  +--+--+  +--+  +  +--+  +  +--+--+  +--+  +  +  +  +  +  +  +
|     |     |        |     |     |  |        |        |     |  |  |  |     |
+  +--+  +--+--+--+--+--+  +  +--+  +  +  +  +  +--+  +  +--+  +  +--+  +--+
|     |     |  |        |  |  |  |     |  |  |     |  |     |     |        |
+  +  +  +  +  +--+  +--+  +  +  +  +--+--+--+--+--+  +  +  +--+  +--+--+--+
|  |  |  |  |  |     |        |           |           |  |  |        |     |
+--+  +--+--+  +--+  +--+--+  +--+--+  +  +--+--+  +--+  +--+  +--+  +  +  +
|     |     |     |              |     |  |  |        |        |     |  |  |
+--+  +--+  +  +  +  +--+--+  +--+  +  +--+  +  +--+--+--+--+--+--+--+  +--+
|        |     |  |        |  |  |  |                       |  |  |        |
+  +--+  +  +  +--+  +--+--+  +  +--+  +--+--+  +--+--+  +--+  +  +  +--+--+
|  |  |     |           |  |     |  |  |  |     |  |  |        |           |
+  +  +--+--+  +--+  +--+  +  +--+  +  +  +  +  +  +  +--+  +--+  +--+--+--+
|  |        |     |        |              |  |  |     |     |     |     |  |
+  +  +  +--+  +--+--+  +  +--+--+--+--+  +  +--+  +--+--+  +  +  +  +--+  +
|  |  |     |     |     |     |           |     |     |     |  |        |  |
+  +  +  +--+  +--+--+--+  +--+--+--+--+  +--+  +--+  +  +  +  +--+--+  +  +
|  |  |     |           |  |  |  |     |     |  |        |           |     |
+--+--+  +  +  +--+  +--+--+  +  +  +--+  +--+--+--+  +--+--+  +  +--+--+  +
|  |  |  |     |  |           |     |  |  |  |  |     |     |  |     |     |
+  +  +  +  +--+  +--+--+  +--+  +  +  +--+  +  +  +--+  +  +  +--+  +--+--+
|        |  |  |  |     |  |  |  |                 |  |  |     |  |        |
+--+--+  +--+  +  +  +--+  +  +  +  +--+  +--+  +--+  +--+  +  +  +--+  +--+
|  |  |        |  |  |        |  |  |  |     |     |  |  |  |     |        |
+  +  +  +--+  +  +  +--+  +  +--+  +  +--+--+--+  +  +  +--+  +--+  +  +  +
|     |     |           |  |  |  |     |        |  |  |  |        |  |  |  |
+  +  +  +--+  +--+--+  +--+--+  +  +  +--+--+  +  +  +  +--+--+--+  +--+  +
|  |     |  |  |  |           |     |  |  |     |     |  |  |  |     |     |
+--+  +  +  +--+  +  +--+  +--+  +  +  +  +  +--+  +--+  +  +  +--+--+--+  +
|  |  |  |           |     |     |  |           |        |        |  |  |  |
+  +--+--+  +--+--+  +  +--+--+--+--+--+--+--+--+  +--+--+  +--+--+  +  +--+
|     |  |  |        |        |        |  |                 |              |
+  +  +  +--+  +--+  +  +--+--+--+  +--+  +  +  +--+  +  +--+  +  +  +--+--+
|  |        |     |  |     |     |  |  |     |     |  |  |  |  |  |        |
+  +--+--+  +--+  +  +--+  +  +  +  +  +  +--+  +  +--+  +  +  +--+--+--+  +
|     |        |  |  |  |     |  |        |     |     |     |  |        |  |
+--+--+  +--+--+  +--+  +  +--+--+--+  +--+--+--+--+  +  +--+--+  +--+--+  +
|  |     |           |     |        |     |  |     |  |        |  |  |     |
+  +--+  +--+--+--+--+  +--+  +--+--+  +  +  +--+  +  +--+  +--+  +  +  +  +
|  |              |     |     |     |  |           |  |              |  |  |
+  +--+--+  +  +--+  +--+--+  +  +--+--+--+  +--+  +--+  +  +  +  +--+--+  +
|  |  |  |  |                 |  |     |     |     |     |  |  |  |  |     |
+  +  +  +--+--+--+--+  +--+--+  +  +--+  +--+--+--+--+--+--+  +--+  +  +--+
|           |              |     |        |     |     |     |        |     |
+  +  +  +--+--+--+--+  +--+--+  +  +  +  +  +  +--+  +  +--+--+  +  +--+  +
|  |  |           |           |     |  |     |        |           |        |
+--+--+  +  +  +  +--+  +  +  +  +--+  +--+--+  +--+--+--+--+  +--+--+  +--+
|        |  |  |        |  |  |  |     |                 |     |            
+--+--+--+--+--+--+--+--+--+--+--+--+--+--+--+--+--+--+--+--+--+--+--+--+--+
